##------################################G-----####
##-####------------------------------########-##-#
#----##-#######-##-#################-########-#--#
#######-##------##--##-###---------#-###------#-##
S-------##############-##--######-##-###-####-#-##
#-#####-###---------##-#--#######--------####-#-##
#-#---#-###-#######-##-#--############-###--#-#-##
#-##-##-###-#######-##----######-------###-##----#
#-##-######-#######-#########----##-##-###-##-##-#
#----##-###-##----------------###---##-----##-##-#
###-----###-##-####-####-####################-##-#
###-##########-####-####---------------######-##-#