####################
##--#----##----###-#
##-#-###-----#-----#
#--#-#-#####-#######
#-##-#----##-#----##
#-##-####-##-####-##
#-##------##-####--G
#-##-####-##-####-##
#----####---------##
#S##################