####################
##--#----##----###-#
##-#-###-----#-----#
#--#-#-#####-#######
#-##-#----##S#----##
#-##-####-##G####-##
#-##------##-####---
#-##-####-##-####-##
#----####---------##
#-##################